Standardized Common Name	Scientific Name	Family	Group
Black-bellied Whistling-Duck	Dendrocygna autumnalis	Anatidae	Fowl (includes water and land)
Greater White-fronted Goose	Anser albifrons	Anatidae	Fowl (includes water and land)
Snow Goose	"Snow Goose
Chen caerulescens"	Anatidae	Fowl (includes water and land)
Ross's Goose	Chen rossii	Anatidae	Fowl (includes water and land)
Canada Goose	Branta canadensis	Anatidae	Fowl (includes water and land)
Mute Swan	Cygnus olor	Anatidae	Fowl (includes water and land)
Wood Duck	Aix sponsa	Anatidae	Fowl (includes water and land)
Gadwall	Anas strepera	Anatidae	Fowl (includes water and land)
American Wigeon	Anas americana	Anatidae	Fowl (includes water and land)
Mallard	Anas platyrhynchos	Anatidae	Fowl (includes water and land)
Mottled Duck	Anas fulvigula	Anatidae	Fowl (includes water and land)
Blue-winged Teal	Anas discors	Anatidae	Fowl (includes water and land)
Cinnamon Teal	Anas cyanoptera	Anatidae	Fowl (includes water and land)
Northern Shoveler	Anas clypeata	Anatidae	Fowl (includes water and land)
Northern Pintail	Anas acuta	Anatidae	Fowl (includes water and land)
Green-winged Teal	Anas crecca	Anatidae	Fowl (includes water and land)
Canvasback	Aythya valisineria	Anatidae	Fowl (includes water and land)
Redhead	Aythya americana	Anatidae	Fowl (includes water and land)
Ring-necked Duck	Aythya collaris	Anatidae	Fowl (includes water and land)
Greater Scaup	Aythya marila	Anatidae	Fowl (includes water and land)
Lesser Scaup	Aythya affinis	Anatidae	Fowl (includes water and land)
Bufflehead	Bucephala albeola	Anatidae	Fowl (includes water and land)
Common Goldeneye	Bucephala clangula	Anatidae	Fowl (includes water and land)
Hooded Merganser	Lophodytes cucullatus	Anatidae	Fowl (includes water and land)
Common Merganser	Mergus merganser	Anatidae	Fowl (includes water and land)
Red-breasted Merganser	Mergus serrator	Anatidae	Fowl (includes water and land)
Ruddy Duck	Oxyura jamaicensis	Anatidae	Fowl (includes water and land)
Scaled Quail	Callipepla squamata	Odontophoridae	Fowl (includes water and land)
Gambel's Quail	Callipepla gambelii	Odontophoridae	Fowl (includes water and land)
Northern Bobwhite	Colinus virginianus	Odontophoridae	Fowl (includes water and land)
Wild Turkey	Meleagris gallopavo	Phasianidae	Fowl (includes water and land)
Common Loon	Gavia immer	Gaviidae	"Loons, Grebes, Cormorants, Pelicans, Herons, Egrets, Ibis"
Least Grebe	Tachybaptus dominicus	Podicipedidae	"Loons, Grebes, Cormorants, Pelicans, Herons, Egrets, Ibis"
Pied-billed Grebe	Podilymbus podiceps	Podicipedidae	"Loons, Grebes, Cormorants, Pelicans, Herons, Egrets, Ibis"
Horned Grebe	Podiceps auritus	Podicipedidae	"Loons, Grebes, Cormorants, Pelicans, Herons, Egrets, Ibis"
Red-necked Grebe	Podiceps grisegena	Podicipedidae	"Loons, Grebes, Cormorants, Pelicans, Herons, Egrets, Ibis"
Eared Grebe	Podiceps nigricollis	Podicipedidae	"Loons, Grebes, Cormorants, Pelicans, Herons, Egrets, Ibis"
Neotropic Cormorant	Phalacrocorax brasilianus	Phalacrocoracidae	"Loons, Grebes, Cormorants, Pelicans, Herons, Egrets, Ibis"
Double-crested Cormorant	Phalacrocorax auritus	Phalacrocoracidae	"Loons, Grebes, Cormorants, Pelicans, Herons, Egrets, Ibis"
Anhinga	Anhinga anhinga	Anhingidae	"Loons, Grebes, Cormorants, Pelicans, Herons, Egrets, Ibis"
American White Pelican	Pelecanus erythrorhynchos	Pelecanidae	"Loons, Grebes, Cormorants, Pelicans, Herons, Egrets, Ibis"
Brown Pelican	Pelecanus occidentalis	Pelecanidae	"Loons, Grebes, Cormorants, Pelicans, Herons, Egrets, Ibis"
Great Blue Heron	Ardea herodias	Ardeidae	"Loons, Grebes, Cormorants, Pelicans, Herons, Egrets, Ibis"
Great Egret	Ardea alba	Ardeidae	"Loons, Grebes, Cormorants, Pelicans, Herons, Egrets, Ibis"
Snowy Egret	Egretta thula	Ardeidae	"Loons, Grebes, Cormorants, Pelicans, Herons, Egrets, Ibis"
Little Blue Heron	Egretta caerulea	Ardeidae	"Loons, Grebes, Cormorants, Pelicans, Herons, Egrets, Ibis"
Tricolored Heron	Egretta tricolor	Ardeidae	"Loons, Grebes, Cormorants, Pelicans, Herons, Egrets, Ibis"
Cattle Egret	Bubulcus ibis	Ardeidae	"Loons, Grebes, Cormorants, Pelicans, Herons, Egrets, Ibis"
Green Heron	Butorides virescens	Ardeidae	"Loons, Grebes, Cormorants, Pelicans, Herons, Egrets, Ibis"
Black-crowned Night-Heron	Nycticorax nycticorax	Ardeidae	"Loons, Grebes, Cormorants, Pelicans, Herons, Egrets, Ibis"
Yellow-crowned Night-Heron	Nyctanassa violacea	Ardeidae	"Loons, Grebes, Cormorants, Pelicans, Herons, Egrets, Ibis"
White Ibis	Eudocimus albus	Threskiornithidae	"Loons, Grebes, Cormorants, Pelicans, Herons, Egrets, Ibis"
White-faced Ibis	Plegadis chihi	Threskiornithidae	"Loons, Grebes, Cormorants, Pelicans, Herons, Egrets, Ibis"
Roseate Spoonbill	Platalea ajaja	Threskiornithidae	"Loons, Grebes, Cormorants, Pelicans, Herons, Egrets, Ibis"
Black Vulture	Coragyps atratus	Cathartidae	"Buteos, Accipiters, Falcons"
Turkey Vulture	Cathartes aura	Cathartidae	"Buteos, Accipiters, Falcons"
Osprey	Pandion haliaetus	Accipitridae	"Buteos, Accipiters, Falcons"
Northern Harrier	Circus cyaneus	Accipitridae	"Buteos, Accipiters, Falcons"
Sharp-shinned Hawk	Accipiter striatus	Accipitridae	"Buteos, Accipiters, Falcons"
Cooper's Hawk	Accipiter cooperii	Accipitridae	"Buteos, Accipiters, Falcons"
Bald Eagle	Haliaeetus leucocephalus	Accipitridae	"Buteos, Accipiters, Falcons"
Harris's Hawk	Parabuteo unicinctus	Accipitridae	"Buteos, Accipiters, Falcons"
Red-shouldered Hawk	Buteo lineatus	Accipitridae	"Buteos, Accipiters, Falcons"
Red-tailed Hawk	Buteo jamaicensis	Accipitridae	"Buteos, Accipiters, Falcons"
Ferruginous Hawk	Buteo regalis	Accipitridae	"Buteos, Accipiters, Falcons"
Crested Caracara	Caracara cheriway	Falconidae	"Buteos, Accipiters, Falcons"
American Kestrel	Falco sparverius	Falconidae	"Buteos, Accipiters, Falcons"
Merlin	Falco columbarius	Falconidae	"Buteos, Accipiters, Falcons"
Peregrine Falcon	Falco peregrinus	Falconidae	"Buteos, Accipiters, Falcons"
Prairie Falcon	Falco mexicanus	Falconidae	"Buteos, Accipiters, Falcons"
Virginia Rail	Rallus limicola	Rallidae	"Rails, Coots, Cranes, Plovers, Sandpipers"
Sora	Porzana carolina	Rallidae	"Rails, Coots, Cranes, Plovers, Sandpipers"
Common Gallinule	Gallinula galeata	Rallidae	"Rails, Coots, Cranes, Plovers, Sandpipers"
American Coot	Fulica americana	Rallidae	"Rails, Coots, Cranes, Plovers, Sandpipers"
Sandhill Crane	Grus canadensis	Gruidae	"Rails, Coots, Cranes, Plovers, Sandpipers"
Black-necked Stilt	Himantopus mexicanus	Recurvirostridae	"Rails, Coots, Cranes, Plovers, Sandpipers"
American Avocet	Recurvirostra americana	Recurvirostridae	"Rails, Coots, Cranes, Plovers, Sandpipers"
Black-bellied Plover	Pluvialis squatarola	Charadriidae	"Rails, Coots, Cranes, Plovers, Sandpipers"
Semipalmated Plover	Charadrius semipalmatus	Charadriidae	"Rails, Coots, Cranes, Plovers, Sandpipers"
Killdeer	Charadrius vociferus	Charadriidae	"Rails, Coots, Cranes, Plovers, Sandpipers"
Greater/Lesser Yellowlegs	Tringa melanoleuca/flavipes	Scolopacidae	"Rails, Coots, Cranes, Plovers, Sandpipers"
Spotted Sandpiper	Actitis macularius	Scolopacidae	"Rails, Coots, Cranes, Plovers, Sandpipers"
Solitary Sandpiper	Tringa solitaria	Scolopacidae	"Rails, Coots, Cranes, Plovers, Sandpipers"
Willet	Tringa semipalmata	Scolopacidae	"Rails, Coots, Cranes, Plovers, Sandpipers"
Ruddy Turnstone	Arenaria interpres	Scolopacidae	"Rails, Coots, Cranes, Plovers, Sandpipers"
Sanderling	Calidris alba	Scolopacidae	"Rails, Coots, Cranes, Plovers, Sandpipers"
Western Sandpiper	Calidris mauri	Scolopacidae	"Rails, Coots, Cranes, Plovers, Sandpipers"
Least Sandpiper	Calidris minutilla	Scolopacidae	"Rails, Coots, Cranes, Plovers, Sandpipers"
Dunlin	Calidris alpina	Scolopacidae	"Rails, Coots, Cranes, Plovers, Sandpipers"
Short-billed/Long-billed Dowitcher	Limnodromus griseus/scolopaceus	Scolopacidae	"Rails, Coots, Cranes, Plovers, Sandpipers"
Wilson's Snipe	Gallinago delicata	Scolopacidae	"Rails, Coots, Cranes, Plovers, Sandpipers"
Laughing Gull	Leucophaeus atricilla	Laridae	"Gulls, Terns, Pigeons, Doves"
Franklin's Gull	Leucophaeus pipixcan	Laridae	"Gulls, Terns, Pigeons, Doves"
Bonaparte's Gull	Chroicocephalus philadelphia	Laridae	"Gulls, Terns, Pigeons, Doves"
Ring-billed Gull	Larus delawarensis	Laridae	"Gulls, Terns, Pigeons, Doves"
California Gull	Larus californicus	Laridae	"Gulls, Terns, Pigeons, Doves"
Herring Gull	Larus argentatus	Laridae	"Gulls, Terns, Pigeons, Doves"
Lesser Black-backed Gull	Larus fuscus	Laridae	"Gulls, Terns, Pigeons, Doves"
Caspian Tern	Hydroprogne caspia	Laridae	"Gulls, Terns, Pigeons, Doves"
Royal Tern	Thalasseus maximus	Laridae	"Gulls, Terns, Pigeons, Doves"
Forster's Tern	Sterna forsteri	Laridae	"Gulls, Terns, Pigeons, Doves"
Black Skimmer	Rynchops niger	Laridae	"Gulls, Terns, Pigeons, Doves"
Rock Pigeon	Columba livia	Columbidae	"Gulls, Terns, Pigeons, Doves"
Eurasian Collared-Dove	Streptopelia decaocto	Columbidae	"Gulls, Terns, Pigeons, Doves"
Inca Dove	Columbina inca	Columbidae	"Gulls, Terns, Pigeons, Doves"
Common Ground-Dove	Columbina passerina	Columbidae	"Gulls, Terns, Pigeons, Doves"
White-winged Dove	Zenaida asiatica	Columbidae	"Gulls, Terns, Pigeons, Doves"
Mourning Dove	Zenaida macroura	Columbidae	"Gulls, Terns, Pigeons, Doves"
Greater Roadrunner	Geococcyx californianus	Neomorphinae	"Roadrunners, Owls, Swifts, Hummingbirds"
Barn Owl	Tyto alba	Tytonidae	"Roadrunners, Owls, Swifts, Hummingbirds"
Eastern Screech-Owl	Megascops asio	Strigidae	"Roadrunners, Owls, Swifts, Hummingbirds"
Great Horned Owl	Bubo virginianus	Strigidae	"Roadrunners, Owls, Swifts, Hummingbirds"
Barred Owl	Strix varia	Strigidae	"Roadrunners, Owls, Swifts, Hummingbirds"
Long-eared Owl	Asio otus	Strigidae	"Roadrunners, Owls, Swifts, Hummingbirds"
Common Pauraque	Nyctidromus albicollis	Caprimulgidae	"Roadrunners, Owls, Swifts, Hummingbirds"
White-throated Swift	Aeronautes saxatalis	Apodinae	"Roadrunners, Owls, Swifts, Hummingbirds"
Anna's Hummingbird	Calypte anna	Trochilidae	"Roadrunners, Owls, Swifts, Hummingbirds"
Broad-tailed Hummingbird	Selasphorus platycercus	Trochilidae	"Roadrunners, Owls, Swifts, Hummingbirds"
Rufous Hummingbird	Selasphorus rufus	Trochilidae	"Roadrunners, Owls, Swifts, Hummingbirds"
Ringed Kingfisher	Megaceryle torquata	Alcedinidae	"Kingfishers, Woodpeckers, Parakeets"
Belted Kingfisher	Megaceryle alcyon	Alcedinidae	"Kingfishers, Woodpeckers, Parakeets"
Green Kingfisher	Chloroceryle americana	Alcedinidae	"Kingfishers, Woodpeckers, Parakeets"
Golden-fronted Woodpecker	Melanerpes aurifrons	Picidae	"Kingfishers, Woodpeckers, Parakeets"
Acorn Woodpecker	Melanerpes formicivorus	Picidae	"Kingfishers, Woodpeckers, Parakeets"
Red-bellied Woodpecker	Melanerpes carolinus	Picidae	"Kingfishers, Woodpeckers, Parakeets"
Yellow-bellied Sapsucker	Sphyrapicus varius	Picidae	"Kingfishers, Woodpeckers, Parakeets"
Ladder-backed Woodpecker	Picoides scalaris	Picidae	"Kingfishers, Woodpeckers, Parakeets"
Downy Woodpecker	Picoides pubescens	Picidae	"Kingfishers, Woodpeckers, Parakeets"
Northern Flicker	Colaptes auratus	Picidae	"Kingfishers, Woodpeckers, Parakeets"
Pileated Woodpecker	Dryocopus pileatus	Picidae	"Kingfishers, Woodpeckers, Parakeets"
Monk Parakeet	Myiopsitta monachus	Psittacidae	"Kingfishers, Woodpeckers, Parakeets"
Eastern Phoebe	Sayornis phoebe	Tyrannidae	"Flycatchers, Shrikes, Vireos, Corvids"
Black Phoebe	Sayornis nigricans	Tyrannidae	"Flycatchers, Shrikes, Vireos, Corvids"
Say's Phoebe	Sayornis saya	Tyrannidae	"Flycatchers, Shrikes, Vireos, Corvids"
Vermilion Flycatcher	Pyrocephalus rubinus	Tyrannidae	"Flycatchers, Shrikes, Vireos, Corvids"
yellow-bellied kingbird sp.	Tyrannus sp. (yellow-bellied)	Tyrannidae	"Flycatchers, Shrikes, Vireos, Corvids"
Scissor-tailed Flycatcher	Tyrannus forficatus	Tyrannidae	"Flycatchers, Shrikes, Vireos, Corvids"
Loggerhead Shrike	Lanius ludovicianus	Laniidae	"Flycatchers, Shrikes, Vireos, Corvids"
White-eyed Vireo	Vireo griseus	Vireonidae	"Flycatchers, Shrikes, Vireos, Corvids"
Blue-headed Vireo	Vireo solitarius	Vireonidae	"Flycatchers, Shrikes, Vireos, Corvids"
Blue Jay	Cyanocitta cristata	Corvidae	"Flycatchers, Shrikes, Vireos, Corvids"
Western Scrub-Jay	Aphelocoma californica	Corvidae	"Flycatchers, Shrikes, Vireos, Corvids"
American Crow	Corvus brachyrhynchos	Corvidae	"Flycatchers, Shrikes, Vireos, Corvids"
Common Raven	Corvus corax	Corvidae	"Flycatchers, Shrikes, Vireos, Corvids"
Tree Swallow	Tachycineta bicolor	Hirundinidae	"Swallows, Chickadees, Titmice, Nuthatches, Wrens"
Cliff/Cave Swallow	Petrochelidon pyrrhonota/fulva	Hirundinidae	"Swallows, Chickadees, Titmice, Nuthatches, Wrens"
Carolina Chickadee	Poecile carolinensis	Paridae	"Swallows, Chickadees, Titmice, Nuthatches, Wrens"
Tufted Titmouse	Baeolophus bicolor	Paridae	"Swallows, Chickadees, Titmice, Nuthatches, Wrens"
Black-crested Titmouse	Baeolophus atricristatus	Paridae	"Swallows, Chickadees, Titmice, Nuthatches, Wrens"
Verdin	Auriparus flaviceps	Remizidae	"Swallows, Chickadees, Titmice, Nuthatches, Wrens"
Red-breasted Nuthatch	Sitta canadensis	Sittidae	"Swallows, Chickadees, Titmice, Nuthatches, Wrens"
White-breasted Nuthatch	Sitta carolinensis	Sittidae	"Swallows, Chickadees, Titmice, Nuthatches, Wrens"
Brown Creeper	Certhia americana	Certhiidae	"Swallows, Chickadees, Titmice, Nuthatches, Wrens"
Rock Wren	Salpinctes obsoletus	Troglodytidae	"Swallows, Chickadees, Titmice, Nuthatches, Wrens"
Canyon Wren	Catherpes mexicanus	Troglodytidae	"Swallows, Chickadees, Titmice, Nuthatches, Wrens"
House Wren	Troglodytes aedon	Troglodytidae	"Swallows, Chickadees, Titmice, Nuthatches, Wrens"
Winter Wren	Troglodytes hiemalis	Troglodytidae	"Swallows, Chickadees, Titmice, Nuthatches, Wrens"
Sedge Wren	Cistothorus platensis	Troglodytidae	"Swallows, Chickadees, Titmice, Nuthatches, Wrens"
Marsh Wren	Cistothorus palustris	Troglodytidae	"Swallows, Chickadees, Titmice, Nuthatches, Wrens"
Carolina Wren	Thryothorus ludovicianus	Troglodytidae	"Swallows, Chickadees, Titmice, Nuthatches, Wrens"
Bewick's Wren	Thryomanes bewickii	Troglodytidae	"Swallows, Chickadees, Titmice, Nuthatches, Wrens"
Cactus Wren	Campylorhynchus brunneicapillus	Troglodytidae	"Swallows, Chickadees, Titmice, Nuthatches, Wrens"
Blue-gray Gnatcatcher	Polioptila caerulea	Sylviidae	"Gnatcatchers, Kinglets, Bluebirds, Thrushes, Thrashers, Mockingbirds"
Golden-crowned Kinglet	Regulus satrapa	Regulidae	"Gnatcatchers, Kinglets, Bluebirds, Thrushes, Thrashers, Mockingbirds"
Ruby-crowned Kinglet	Regulus calendula	Regulidae	"Gnatcatchers, Kinglets, Bluebirds, Thrushes, Thrashers, Mockingbirds"
Eastern Bluebird	Sialia sialis	Turdidae	"Gnatcatchers, Kinglets, Bluebirds, Thrushes, Thrashers, Mockingbirds"
Western Bluebird	Sialia mexicana	Turdidae	"Gnatcatchers, Kinglets, Bluebirds, Thrushes, Thrashers, Mockingbirds"
Hermit Thrush	Catharus guttatus	Turdidae	"Gnatcatchers, Kinglets, Bluebirds, Thrushes, Thrashers, Mockingbirds"
American Robin	Turdus migratorius	Turdidae	"Gnatcatchers, Kinglets, Bluebirds, Thrushes, Thrashers, Mockingbirds"
Gray Catbird	Dumetella carolinensis	Mimidae	"Gnatcatchers, Kinglets, Bluebirds, Thrushes, Thrashers, Mockingbirds"
Curve-billed Thrasher	Toxostoma curvirostre	Mimidae	"Gnatcatchers, Kinglets, Bluebirds, Thrushes, Thrashers, Mockingbirds"
Brown Thrasher	Toxostoma rufum	Mimidae	"Gnatcatchers, Kinglets, Bluebirds, Thrushes, Thrashers, Mockingbirds"
Long-billed Thrasher	Toxostoma longirostre	Mimidae	"Gnatcatchers, Kinglets, Bluebirds, Thrushes, Thrashers, Mockingbirds"
Crissal Thrasher	Toxostoma crissale	Mimidae	"Gnatcatchers, Kinglets, Bluebirds, Thrushes, Thrashers, Mockingbirds"
Northern Mockingbird	Mimus polyglottos	Mimidae	"Gnatcatchers, Kinglets, Bluebirds, Thrushes, Thrashers, Mockingbirds"
European Starling	Sturnus vulgaris	Sturnidae	"Starlings, Pipits, Waxwings, Warblers"
American Pipit	Anthus rubescens	Motacillidae	"Starlings, Pipits, Waxwings, Warblers"
Sprague's Pipit	Anthus spragueii	Motacillidae	"Starlings, Pipits, Waxwings, Warblers"
Cedar Waxwing	Bombycilla cedrorum	Bombycillidae	"Starlings, Pipits, Waxwings, Warblers"
Phainopepla	Phainopepla nitens	Ptilogonatidae	"Starlings, Pipits, Waxwings, Warblers"
Black-and-white Warbler	Mniotilta varia	Parulidae	"Starlings, Pipits, Waxwings, Warblers"
Orange-crowned Warbler	Oreothlypis celata	Parulidae	"Starlings, Pipits, Waxwings, Warblers"
Common Yellowthroat	Geothlypis trichas	Parulidae	"Starlings, Pipits, Waxwings, Warblers"
Yellow Warbler	Setophaga petechia	Parulidae	"Starlings, Pipits, Waxwings, Warblers"
Pine Warbler	Setophaga pinus	Parulidae	"Starlings, Pipits, Waxwings, Warblers"
Yellow-rumped Warbler	Setophaga coronata	Parulidae	"Starlings, Pipits, Waxwings, Warblers"
Grasshopper Sparrow	Ammodramus savannarum	Emberizidae	"Sparrows, Towhees, Cardinals"
Le Conte's Sparrow	Ammodramus leconteii	Emberizidae	"Sparrows, Towhees, Cardinals"
Seaside Sparrow	Ammodramus maritimus	Emberizidae	"Sparrows, Towhees, Cardinals"
Chipping Sparrow	Spizella passerina	Emberizidae	"Sparrows, Towhees, Cardinals"
Black-chinned Sparrow	"Black-chinned Sparrow
Spizella atrogularis"	Emberizidae	"Sparrows, Towhees, Cardinals"
Brewer's Sparrow	Spizella breweri	Emberizidae	"Sparrows, Towhees, Cardinals"
Field Sparrow	Spizella pusilla	Emberizidae	"Sparrows, Towhees, Cardinals"
Black-throated Sparrow	Amphispiza bilineata	Emberizidae	"Sparrows, Towhees, Cardinals"
Lark Sparrow	Chondestes grammacus	Emberizidae	"Sparrows, Towhees, Cardinals"
Lark Bunting	Calamospiza melanocorys	Emberizidae	"Sparrows, Towhees, Cardinals"
Fox Sparrow	Passerella iliaca	Emberizidae	"Sparrows, Towhees, Cardinals"
Dark-eyed Junco	Junco hyemalis	Emberizidae	"Sparrows, Towhees, Cardinals"
White-crowned Sparrow	Zonotrichia leucophrys	Emberizidae	"Sparrows, Towhees, Cardinals"
Harris's Sparrow	Zonotrichia querula	Emberizidae	"Sparrows, Towhees, Cardinals"
White-throated Sparrow	Zonotrichia albicollis	Emberizidae	"Sparrows, Towhees, Cardinals"
Vesper Sparrow	Pooecetes gramineus	Emberizidae	"Sparrows, Towhees, Cardinals"
Savannah Sparrow	Passerculus sandwichensis	Emberizidae	"Sparrows, Towhees, Cardinals"
Song Sparrow	Melospiza melodia	Emberizidae	"Sparrows, Towhees, Cardinals"
Lincoln's Sparrow	Melospiza lincolnii	Emberizidae	"Sparrows, Towhees, Cardinals"
Swamp Sparrow	Melospiza georgiana	Emberizidae	"Sparrows, Towhees, Cardinals"
Rufous-crowned Sparrow	Aimophila ruficeps	Emberizidae	"Sparrows, Towhees, Cardinals"
Canyon Towhee	Melozone fusca	Emberizidae	"Sparrows, Towhees, Cardinals"
Green-tailed Towhee	Pipilo chlorurus	Emberizidae	"Sparrows, Towhees, Cardinals"
Spotted Towhee	Pipilo maculatus	Emberizidae	"Sparrows, Towhees, Cardinals"
Eastern Towhee	Pipilo erythrophthalmus	Emberizidae	"Sparrows, Towhees, Cardinals"
Pyrrhuloxia	Cardinalis sinuatus	Cardinalidae	"Sparrows, Towhees, Cardinals"
Northern Cardinal	Cardinalis cardinalis	Cardinalidae	"Sparrows, Towhees, Cardinals"
Red-winged Blackbird	Agelaius phoeniceus	Icteridae	"Blackbirds, Finches, Weaverfinches"
Western/Eastern Meadowlark	Sturnella neglecta/magna	Icteridae	"Blackbirds, Finches, Weaverfinches"
Yellow-headed Blackbird	Xanthocephalus xanthocephalus	Icteridae	"Blackbirds, Finches, Weaverfinches"
Rusty Blackbird	Euphagus carolinus	Icteridae	"Blackbirds, Finches, Weaverfinches"
Brewer's Blackbird	Euphagus cyanocephalus	Icteridae	"Blackbirds, Finches, Weaverfinches"
Common Grackle	Quiscalus quiscula	Icteridae	"Blackbirds, Finches, Weaverfinches"
Boat-tailed Grackle	Quiscalus major	Icteridae	"Blackbirds, Finches, Weaverfinches"
Great-tailed Grackle	Quiscalus mexicanus	Icteridae	"Blackbirds, Finches, Weaverfinches"
Brown-headed Cowbird	Molothrus ater	Icteridae	"Blackbirds, Finches, Weaverfinches"
Hooded Oriole	Icterus cucullatus	Icteridae	"Blackbirds, Finches, Weaverfinches"
House Finch	Haemorhous mexicanus	Fringillidae	"Blackbirds, Finches, Weaverfinches"
Pine Siskin	Spinus pinus	Fringillidae	"Blackbirds, Finches, Weaverfinches"
Lesser Goldfinch	Spinus psaltria	Fringillidae	"Blackbirds, Finches, Weaverfinches"
American Goldfinch	Spinus tristis	Fringillidae	"Blackbirds, Finches, Weaverfinches"
House Sparrow	Passer domesticus	Passeridae	"Blackbirds, Finches, Weaverfinches"
